[
    ["b", "b", "b", "b", "b"],
    ["b", "c", "c", "c", "c"],
    ["b", "c", "b", "b", "b"],
    ["b", "c", "b", "c", "b"],
    ["b", "c", "c", "c", "b"],
    ["b", "c", "b", "c", "b"]
]