[
    ["b", "b", "c", "c", "b", "b", "b", "c", "b", "b", "b", "b", "b", "b", "c", "c", "c", "b", "b", "b"],
    ["b", "c", "c", "c", "b", "p", "p", "p", "b", "p", "p", "p", "b", "p", "p", "p", "b", "p", "p", "b"],
    ["b", "c", "b", "c", "b", "b", "b", "p", "b", "b", "b", "p", "b", "b", "b", "p", "b", "b", "p", "b"],
    ["c", "c", "b", "c", "c", "c", "b", "p", "p", "p", "b", "p", "p", "p", "b", "p", "p", "p", "b", "b"],
    ["b", "c", "b", "b", "b", "c", "b", "b", "b", "b", "b", "b", "b", "c", "b", "b", "b", "b", "b", "b"],
    ["b", "c", "c", "c", "b", "p", "p", "p", "b", "p", "p", "p", "b", "p", "p", "p", "b", "p", "p", "b"],
    ["b", "c", "b", "b", "b", "b", "b", "p", "b", "b", "b", "p", "b", "b", "b", "p", "b", "b", "p", "b"],
    ["b", "c", "c", "c", "b", "p", "p", "p", "b", "p", "p", "p", "b", "p", "p", "p", "b", "p", "p", "b"],
    ["b", "c", "b", "c", "b", "b", "b", "b", "b", "b", "b", "b", "b", "c", "b", "b", "b", "b", "b", "b"],
    ["c", "c", "c", "c", "c", "c", "b", "p", "p", "p", "b", "p", "p", "p", "b", "p", "p", "p", "f", "b"],
    ["c", "c", "b", "b", "b", "c", "b", "b", "b", "b", "b", "b", "b", "c", "b", "b", "b", "b", "b", "b"],
    ["b", "c", "c", "c", "b", "p", "p", "p", "b", "p", "p", "p", "b", "p", "p", "p", "b", "p", "p", "b"],
    ["b", "c", "b", "c", "b", "b", "b", "p", "b", "b", "b", "p", "b", "b", "b", "p", "b", "b", "p", "b"],
    ["c", "c", "c", "c", "c", "c", "c", "p", "p", "p", "p", "p", "c", "c", "c", "p", "p", "p", "c", "b"],
    ["b", "c", "b", "b", "b", "b", "b", "b", "b", "b", "b", "b", "b", "b", "b", "b", "b", "b", "c", "b"],
    ["b", "c", "c", "c", "c", "c", "c", "c", "c", "b", "b", "b", "c", "c", "c", "c", "c", "c", "c", "b"],
    ["b", "b", "b", "b", "b", "b", "b", "b", "c", "b", "b", "c", "c", "b", "b", "b", "c", "b", "b", "b"]
]
