[
    ["r", "b", "b", "b", "b", "b", "b", "b", "b", "b", "b", "b", "b", "b", "b", "b", "b", "b", "b", "l"],
    ["b", "c", "c", "c", "b", "c", "c", "c", "b", "b", "b", "c", "c", "c", "c", "b", "c", "c", "c", "b"],
    ["b", "c", "b", "c", "b", "c", "c", "c", "c", "c", "c", "c", "c", "b", "c", "b", "c", "c", "c", "b"],
    ["b", "c", "c", "c", "c", "c", "c", "c", "c", "c", "c", "c", "c", "b", "c", "c", "c", "c", "c", "b"],
    ["b", "c", "c", "c", "c", "c", "c", "c", "c", "c", "c", "c", "c", "c", "c", "c", "c", "b", "b", "b"],
    ["b", "c", "b", "c", "c", "c", "c", "b", "b", "b", "c", "c", "c", "c", "c", "c", "c", "c", "c", "b"],
    ["b", "c", "b", "b", "c", "c", "c", "c", "c", "c", "c", "c", "c", "c", "b", "b", "c", "c", "c", "b"],
    ["b", "c", "c", "c", "c", "c", "c", "c", "c", "c", "c", "c", "c", "c", "b", "c", "c", "c", "c", "b"],
    ["b", "c", "c", "c", "c", "c", "c", "c", "c", "c", "c", "c", "c", "c", "c", "c", "c", "c", "c", "b"],
    ["b", "c", "c", "c", "b", "b", "c", "c", "c", "c", "c", "c", "c", "c", "c", "c", "b", "c", "c", "b"],
    ["b", "c", "c", "c", "c", "c", "c", "c", "c", "c", "c", "c", "b", "c", "b", "c", "b", "b", "c", "b"],
    ["b", "c", "c", "c", "c", "c", "c", "c", "b", "c", "c", "c", "b", "c", "b", "c", "c", "c", "c", "b"],
    ["b", "c", "b", "c", "c", "c", "c", "c", "b", "b", "b", "c", "c", "c", "c", "c", "c", "c", "c", "b"],
    ["b", "c", "c", "c", "c", "b", "c", "b", "c", "c", "b", "c", "c", "c", "c", "c", "c", "c", "c", "b"],
    ["b", "c", "c", "b", "b", "b", "c", "c", "c", "c", "c", "c", "c", "c", "c", "c", "c", "c", "c", "b"],
    ["b", "c", "c", "c", "c", "c", "c", "b", "c", "c", "c", "b", "b", "c", "c", "c", "c", "c", "c", "b"],
    ["g", "b", "b", "b", "b", "b", "b", "b", "b", "b", "b", "b", "b", "b", "b", "b", "b", "b", "b", "y"]
]
